%%%%%%%%%%%%%
%    %  P   %
%  % %%%%%  %
% %    % %  %
%  % %   %% %
%%%%% %  %  %
%     % %% %%
%. %       %%
%%%%%%%%%%%%%